    XXXXX             
    X   X             
    X$  X
  XXX  BXXX           
  X  $  $ X
XXX X XXX X     XXXXXX
X   X XXX XXXXXXX  ..X
X $  $             ..X
XXXXX XXXX X@XXXX  ..X
    X      XXX  XXXXXX
    XXXXXXXX          