######
#.@$ #
# $. #
#  $ #
# . ##
######
